10000000000000000000000000000000000000000000000000000000000000000000000000000000
10000000000000000000000000000000000000000000000000000000000000000000000000000000
10000000000000000000000000000000000000000000000000000000000000000000000000000000
10000000000000000000000000000000000000000000000000000000000000000000000000000000
10000000000000000000000000000000000000000000000000000000000000000000000000000000
10000000000000000000000000000000000000000000000000000000000000000000000000000000
10000000000000000000000000000000000000000000000000000000000000000000000000000000
10000000000000000000000000000000000000000000000000000000000000000000000000000000
10000009111111118000000000000000000000000000000000000000000000000022220000000000
10000091111111111800000000000000000000000000000000000000000000000022220000000000
10000911111111111180000000000000000000002222000000000000000000000000000000000000
10009111111111111118000000000000000000002222000000000000000000000000000000000000
11111111111111111111111100000000222200000000000011110000000000000000000000000000
11111111111111111111111100000000222200000000000011110000000000000000000000000000
11111111111111111111111100000000000000000000000000000000000000000000000000000000
11111111111111111111111100000000000000000000000000000000000000000000000000000000
10000000000000000000000000000000222200000000222200000000111100000011110000001111
10000000000000000000000000000000222200000000222200000000111100000011110000001111
10000000000000000000000000000000000000000000000000000000111100000000000000001111
10000000000000000000000000000000000000000000000000000000111100000000000000001111
10000000000000111100000000000000222200000000000000000000111177777777777777771111
10000000000000111100000000000000222200000000000000000000111177777777777777771111
10000000000000111100000000000000000000000000000000000000111177777777777777771111
10000000000000111100000000000000000000000000000000000000111177777777777777771111
10000000111111111111111100000000111111112662111100001111111177777777777777771111
10000000111111111111111100000000111111112662111100001111111177777777777777771111
10000000111111111111111100000000111111112662111100001111111177777777777777771111
10000000111111111111111100000000111111112662111100001111111177777777777777771111
10000000000000000000000000000000000000000660111100000000111111111111111111111111
10000000000000000000000000000000000000000660111100000000111111111111111111111111
10000000000000000000000000000000000000000660111100000000111111111111111111111111
10000000000000000000000000000000000000000660111100000000000000000000000000001111
11118000000000000000000000000000000000000660111100000000000000000000000000001111
11111800000000000000000000000000000000000660111100000000000000000000000000001111
11111180000000000000000000000000000000000660111100000000000000000000000000001111
11111118000000000000000000000000000000000660111100000000000000000000000000001111
11111111cd0000000000000011111111111111111111111100000000000000001111111100001111
1111111111cd00000000000011111111111111111111111100000000000000001111111100001111
111111111111cd000000000011111111111111111111111100000000000000001111111100001111
11111111111111cd0000000011111111111111111111111100000000000000001111111100001111
11111111111111118000000000000000000000000000000000000000111111111111111111111111
11111111111111111800000000000000000000000000000000000000111111111111111111111111
11111111111111111180000000000000000000000000000000000000111111111111111111111111
11111111111111111118000000000000000000000000000000000000111111111111111111111111
11111111111111111111800000000000000000000000000000000000111111111111111111111111
11111111111111111111180000000000000000000000000000000000111111111111111111111111
11111111111111111111118000000000000000000000000000000000111111111111111111111111
11111111111111111111111800000000000000000000000000000000111111111111111111111111
111111111111111111111111cd000000000000000000000911111111111111111111111111111111
11111111111111111111111111cd0000000000000000009111111111111111111111111111111111
1111111111111111111111111111cd00000000000000091111111111111111111111111111111111
111111111111111111111111111111cd000000000000911111111111111111111111111111111111
11111111111111111111111111111111111111111111111111111111111111111111111111111111
11111111111111111111111111111111111111111111111111111111111111111111111111111111
11111111111111111111111111111111111111111111111111111111111111111111111111111111
11111111111111111111111111111111111111111111111111111111111111111111111111111111
11111111111111111111111111111111111111111111111111111111111111111111111111111111
11111111111111111111111111111111111111111111111111111111111111111111111111111111
11111111111111111111111111111111111111111111111111111111111111111111111111111111
11111111111111111111111111111111111111111111111111111111111111111111111111111111
