10000000000000000000000000000000000000000000000000000000000000000000000000000001
10000000000000000000000000000000000000000000000000000000000000000000000000000001
10000000000000000000000000000000000000000000000000000000000000000000000000000001
10000000000000000000000000000000000000000000000000000000000000000000000000000001
10000000000000000000000000000000000000000000000000000000000000000000000000000001
10000000000000000000000000000000000000000000000000000000000000000000000000000001
10000000000000000000000000000000000000000000000000000000000000000000000000000001
10000000000000000000000000000000000000000000000000000000000000000000000000000001
12222111111100000011111111111111111100000011111111111111111100000001111111111111
177771111A00000000000000000000000000000000000000000000000000000000000000000B1111
17777111A0000000000000000000000000000000000000000000000000000000000000000000B111
1777711A000000000000000000000000000000000000000000000000000000000000000000000B11
177771A0000000NL0000NL0000NL0000NL0000NL0000NL0000NL0000NL0000NL0000NL00000000B1
17777100000000MK0000MK0000MK0000MK0000MK0000MK0000MK0000MK0000MK0000MK0000000001
17777100000000QO0000QO0000QO0000QO0000QO0000QO0000QO0000QO0000QO0000QO0000000001
17777100000000RP0000RP0000RP0000RP0000RP0000RP0000RP0000RP0000RP0000RP0000000001
17777100000000000000000000000000000000000000000000000000000000000000000000000001
17777100000000000000000000000000000000000000000000000000000000000000000000000001
17777100000000000000000000000000000000000000000000000000000000000000000000000001
17777100000NL0000000000NL0000000000NL0000000000NL0000000000NL0000000000NL0000001
17777100000MK0000980000MK0000980000MK0000980000MK0000980000MK0000980000MK0000001
17777100000QO0000BA0000QO0000BA0000QO0000BA0000QO0000BA0000QO0000BA0000QO0000001
17777100000RP0000000000RP0000000000RP0000000000RP0000000000RP0000000000RP0000001
17777100000000000000000000000000000000000000000000000000000000000000000000000001
17777100000000000000000000000000000000000000000000000000000000000000000000000001
17777100000000000000000000000000000000000000000000000000000000000000000000000001
17777100000000NL0000NL0000NL0000NL0000NL0000NL0000NL0000NL0000NL0000NL0000000001
17777180000000MK0000MK0000MK0000MK0000MK0000MK0000MK0000MK0000MK0000MK0000000091
17777118000000QO0000QO0000QO0000QO0000QO0000QO0000QO0000QO0000QO0000QO0000000911
17777111800000RP0000RP0000RP0000RP0000RP0000RP0000RP0000RP0000RP0000RP0000009111
17777100000000000000000000000000000000000000000000000000000000000000000000000001
17777100000000000000000000000000000000000000000000000000000000000000000000000001
17777100000000000000000000000000000000000000000000000000000000000000000000000001
17777100000000000000000000000000000000000000000000000000000000000000000000000001
1777710000ECD00000000FEC0000ECD00000000FEC0000ECD00000000FEC0000ECD00000000FEC01
17777100000JICD0000FEGH000000JICD0000FEGH000000JICD0000FEGH000000JICD0000FEGH001
1777710000000JI0000GH0000000000JI0000GH0000000000JI0000GH0000000000JI0000GH00001
17777100000000000000000000000000000000000000000000000000000000000000000000000001
17777100000000000000000000000000000000000000000000000000000000000000000000000001
17777100000000000000000000000000000000000000000000000000000000000000000000000001
17777100000000000000000000000000000000000000000000000000000000000000000000000001
17777100000000000000000000000000000000000000000000000000000000000000000000000001
17777100000000000000000000000000000000000000000000000000000000000000000000000001
17777100000000000000000000000000000000000000000000000000000000000000000000000001
17777100000000000000000000000000000000000000000000000000000000000000000000000001
17777100000000000000000000000000000000000000000000000000000000000000000000000001
17777100000000000000000000000000000000000000000000000000000000000000000000000001
177771000L0000L0000L0000L0000L0000L0000L0000L0000L0000L0000L0000L0000L0000L00001
177771000K0000K0000K0000K0000K0000K0000K0000K0000K0000K0000K0000K0000K0000K00001
17777100010000100001000010000100001000010000100001000010000100001000010000100001
17777100010000100001000010000100001000010000100001000010000100001000010000100001
17777100010000100001000010000100001000010000100001000010000100001000010000100001
17777100010000100001000010000100001000010000100001000010000100001000010000100001
17777100010000100001000010000100001000010000100001000010000100001000010000100001
17777100040000400004000040000400004000040000400004000040000400004000040000400001
17777000040000400004000040000400004000040000400004000040000400004000040000400001
17777000040000400004000040000400004000040000400004000040000400004000040000400001
17777000040000400004000040000400004000040000400004000040000400004000040000400001
17777000040000400004000040000400004000040000400004000040000400004000040000400001
11111111111111111111111111111111111111111111111111111111111111111111111111111111
