10000000000000000000000000000000000000000000000000000000000000000000000000000001
10000000000000000000000000000000000000000000000000000000000000000000000000000001
10000000000000000000000000000000000000000000000000000000000000000000000000000001
10000000000000000000000000000000000000000000000000000000000000000000000000000001
10000000000000000000000000000000000000000000000000000000222202220000000000000001
10000000000000000000000002222022200000000000000000000002222222222000000000000001
10000000000000000000000022222222220000000000000000000002222222222000000000000001
10000000000000000000000022222222220000000222202220000000000000000000000000000001
10000000000000000000000000000000000000002222222222000000000000000000000000000001
10000000000000000000000000000000000000002222222222000000000000000000000000000001
102662222111111CD00000000000000000000000000QK00000000000000000000000000000000001
100660000000000JICD000000000000000000000000R1L0000000000000000000000000000000001
10066000000000000JICD000000000000000000000091K0000000000000000000000000000000001
1006600000000000000JI00000000000000000000091AQL000000000000000000000000000000001
1006600000000000000000000000000000000000091A0RK000000000000000000000000000000001
10066000000000000000000000000000000000000QA00NO000000000000000000000000000000001
10066000000000000000000000000000000000000R000MP000000000000000000000000000000001
10066000000000000000000000000000000000000000NO0000000000000NO0000NO2222222222001
10222200000000000000000000000000000000000000MP0000000000000MP0000MP0000000000001
10066000000000000000000000000000000000000000Q0000000000000NO0000NO00000000000001
10066000000000000000000000000000000000000000R0000000000000MP0000MP02222222222001
100660000000000000000000000000000000000000000000000000000NO0000NO000000000000001
100660000000000000000000000000000000000000000000000000000MP0000MP000000000000001
10066000000000000000000000000000000000000000000000000000NO0000NO0002222222222001
10066000000000000000000000000000000000000000000000000000MP0000MP0000000000000001
1006600000000000000000000000000000000000000000000000000NO0000NO00000000000000001
1022220000000000000000000000000000000000000000000000000MP0000MP00002222222222001
100660000000000000000000000000000000000000000000000000NO0000NO000000000000000001
100660000000000000000000000000000000000000000000000000MP0000MP000000000000000001
10066000000000000000000000000000000000000000000000000NO0000NO0000002222222222001
10066000000000000000000000000000000000000000000000000MP0000MP0000000000000000001
1006600000000000000000000000000000000000000000000000NO0000NO00000000000000000001
1006600000000000000000000000000000000000000000000000MP0000MP00000002222222222001
100660000000000000000000000000000000000000000000000NO0000NO000000000000000000001
102222222111CD0000000000000000000000000000000000000MP0000MP000000000000000000001
100660000000JICD0000000000000000000000000000000000000000000000000002222222222001
10066000000000JICD00000000000000000000000000000000000000000000000000000000000001
1006600000000000JI00000000000000000000000000000000000000000000000000000000000001
10066000000000000000000000000000000000000000000000000000000000000002222222222001
10066000000000000000000000000000000000000000000000000000000000000000000000000001
10066000000000000000000000000000000000000000000000000000000000000000000000000001
10066000000000000000000000000000000000000000000000000000000000000002222222222001
10222200000000000000000000000000000000000000000000000000000000000000000000000001
10066000000000000111100000000000000000000000000000000000000000000000000001111001
10066000000000000111177777777777777777777777777777777777777777777777777771111001
10066000000000000001177777777777777777777777777777777777777777777777777771100001
10066000000000000001177777777777777777777777777777777777777777777777777771100001
10066000000000000001177777777777777777777777777777777777777777777777777771100001
10066000000000000001177777777777777777777777777777777777777777777777777771100001
10066000000000000001177777777777777777777777777777777777777777777777777771100001
10222200000000000001177777777777777777777777777777777777777777777777777771100001
10066000000000000001177777777777777777777777777777777777777777777777777771100001
10066000000000000004477777777777777777777777777777777777777777777777777771100001
10066000000000000004477777777777777777777777777777777777777777777777777771100001
10066000000000000004477777777777777777777777777777777777777777777777777771100001
10066000000000000004477777777777777777777777777777777777777777777777777771100001
10066000000000000004477777777777777777777777777777777777777777777777777771100001
10066000000000000004477777777777777777777777777777777777777777777777777771100001
10066000000000000004477777777777777777777777777777777777777777777777777771100001
11111111111111111111111111111111111111111111111111111111111111111111111111111111
