10000000000000000000000000000000000000000000000000000000000000000000000000000001
10000000000000000000000000011110000000000000111100000000000000000000000000000001
10000000000000000000000111100000000000000000000011110000000000000000000000000001
10000000000000000001111000000000000000000000000000001111000000000000000000000001
10000000000000000000000000000000000000000000000000000000000000000000000000000001
10000000000000000000011111111110000000000000111111111100000000000000000000000001
10000000000000000000100000000001000000000001000000000010000000000000000000000001
10000000000000000001000000000000100000000010000000000001000000000000000000000001
10222222222222220001000000000000100000000010000000000001000222222222222222222201
10000000000000000001011111111110100000000010111111111101000000000000000000000001
10000000000000000001000100001000100000000010001000010001000000000000000000000001
10000000000000000001000100001000100000000010001000010001000000000000000000000001
10000000000000000001000011110000100000000010000111100001000000000000000000000001
10222222222222220000100000000001000000000001000000000010000222222222222222222201
10000000000000000000011111111110000000000000111111111100000000000000000000000001
10000000000000000000000000000000000000000000000000000000000000000000000000000001
10000000000000000000000000000000000000000000000000000000000000000000000000000001
10000000000000000000000000000000000000000000000000000000000000000000000000000001
10222222222222220000000000000000001100011000000000000000000222222222222222222201
10000000000000000000000000000000010010100100000000000000000000000000000000000001
10000000000000000000000000000000000000000000000000000000000000000000000000000001
10000000000000000000000000000000000000000000000000000000000000000000000000000001
10000000000000000000100000000000000000000000000000000001000000000000000000000001
10222222222222220000010000000000000000000000000000000010000222222222222222222201
10000000000000000000001000000000000000000000000000000100000000000000000000000001
10000000000000000000000110000000000000000000000000011000000000000000000000000001
10000000000000000000000001110000000000000000000011100000000000000000000000000001
10000000000000000000000000101111111111111111111101000000000000000000000000000001
10222222222222222220000000010000000000000000000010000000022222222222222222222201
10000000000000000000000000001100000000000000001100000000000000000000000000000001
10000000000000000000000000000011111111111111111000000000000000000000000000000001
10000000000000000000000000000000000000000000000000000000000000000000000000000001
10000000000000000000000000000000000000000000000000000000000000000000000000000001
10222222222222222222222200000000000000000000000000000222222222222222222222222201
10000000000000000000000000000000000000000000000000000000000000000000000000000001
10000000000000000000000000000000000000000000000000000000000000000000000000000001
10000000000000000000000000000000000000000000000000000000000000000000000000000001
10000000000000000000000000000000000000000000000000000000000000000000000000000001
1011111111111111111010001000nl0001800018000ql0no01111111111111111111111111111101
1000000000000000000010001000mk0001b8001b800rk0mp00000000000000000000000000000001
100000000000000000001111100noql0010bl010bl00q1o000000000000000000000000000000001
100000000000000000001000100mprk00111p0111p00r1p000000000000000000000000000000001
10000000000000000000100010n1111l010000100000010000000000000000000000000000000001
10111111111111111110100010mp00rk010000100000010001111111111111111111111111111101
10000000000000000000000000000000000000000000000000000000000000000000000000000001
1000000000000000000018001110180011111010010180000nl00ql0no0000000000000000000001
100000000000000000001b8001001b80001000100101b8000mk00rk0mp0000000000000000000001
1000000000000000000019a0010010bl0010001111010b80noql00q1o00000000000000000000001
101111111111111111101b800100111p00100010010109a0mprk00r1p01111111111111111111101
1000000000000000000019a001001cd00010001001019a0n1111l001000000000000000000000001
100000000000000000001a0011101ji0001000100101a00mp00rk001000000000000000000000001
10000000000000000000000000000000000000000000000000000000000000000000000000000001
1000000000000000000000nl0001l0101l0101110111010000000000000000000000000000000001
1011111111111111111000mk0001k0101k0100100100010111111111111111111111111111111101
100000000000000000000noql001ql101ql100100111010000000000000000000000000000000001
100000000000000000000mprk001rk101rk100100100010000000000000000000000000000000001
10000000000000000000n1111l010q1010q100100100000000000000000000000000000000000001
10000000000000000000mp00rk010r1010r101110111010000000000000000000000000000000001
10000000000000000000000000000000000000000000000000000000000000000000000000000001
11111111111111111111111111111111111111111111111111111111111111111111111111111111
